111111111
100000C01
10P00C001
10C000E01
100000001
111111111