111111111
1101000C1
10P00C011
11C010G01
10100E111
111111111
