111111111
1G01000C1
10P00C011
11C010G01
11100E111
111111111
