111111111
100000C01
10P00C001
10C000001
10000E001
111111111