111111111
100000C1
10P00C011
10C00G01
10000E001
111111111