111110111
1000000C1
10P00C011
10C000G01
10000E001
111111111