111111111
1000000E1
10P00C011
10C000G01
10F00C001
111111111