111111111
100000001
10P000011
100000G01
10000E001
111111111