111111111
1000001E1
10P00C011
10C000G01
10000C001
111111111