111111111
1000000C1
10P00C011
10C000G01
100000001
111111111