111111111
1000000C1
10000C011
10C000G01
10000E001
111111111