11111
1P1E1
1C001
10001
1  C1
11111